acetaminophen: an analgesic for mild pain but not for inflammation; also used as an antipyretic; (Datril, Tylenol, Panadol, Phenaphen, Tempra, and Anacin III are trademarks of brands of acetaminophen tablets)

dose: a measured portion of medicine taken at any one time

developing: processing a photosensitive material in order to make an image visible

severe: intensely or extremely bad or unpleasant in degree or quality

opioid: sorry, the definition of this word is not currently available.

generic: a wine that is a blend of several varieties of grapes with no one grape predominating; a wine that does not carry the name of any specific grape

vein: a blood vessel that carries blood from the capillaries toward the heart

maximum: the largest possible quantity

medication: (medicine) something that treats or prevents or alleviates the symptoms of disease

significant: important in effect or meaning

failure: an act that fails

mouth: the opening through which food is taken in and vocalizations emerge

relief: the feeling that comes when something burdensome is removed or reduced

many: a quantifier that can be used with count nouns and is often preceded by `as' or `too' or `so' or `that'; amounting to a large but indefinite number

adult: a fully developed person from maturity onward

pain: a symptom of some physical hurt or disorder

liver: large and complicated reddish-brown glandular organ located in the upper right portion of the abdominal cavity; secretes bile and functions in metabolism of protein and carbohydrate and fat; synthesizes substances involved in the clotting of the blood; synthesizes vitamin A; detoxifies poisonous substances and breaks down worn-out erythrocytes

effective: producing or capable of producing an intended result or having a striking effect; -LewisMumford

disease: an impairment of health or a condition of abnormal functioning

analgesic: a medicine used to relieve pain

mixed: mix together different elements

use: the act of using

combination: a collection of things that have been combined; an assemblage of separate parts or qualities

skin: a natural protective body covering and site of the sense of touch

used: put into service; make work or employ for a particular purpose or for its inherent or natural purpose

cancer: any malignant growth or tumor caused by abnormal and uncontrolled cell division; it may spread to other parts of the body through the lymphatic system or the blood stream

fever: a rise in the temperature of the body; frequently a symptom of infection

daily: a newspaper that is published every day

injection: the forceful insertion of a substance under pressure

pregnancy: the state of being pregnant; the period from conception to birth when a woman carries a developing fetus in her uterus

safe: strongbox where valuables can be safely kept

activity: any specific behavior

cold: a mild viral infection involving the nose and respiratory passages (but not the lungs)

available: obtainable or accessible and ready for use or service

surgery: the branch of medical science that treats disease or injury by operative procedures

toxicity: the degree to which something is poisonous

clear: the state of being free of suspicion

